id,count
12602104,2
12602114,1
12578024,28
12602122,1
12602124,4
12602126,1
