id,count
12602107,6
12602126,4
12578024,2
12602122,4
12602139,2
12602124,5
2346573,1
22525998,2
