id,count
12602104,2
12602114,1
12578024,27
12602122,1
12602124,6
12602126,1
